Sample_ID	Population
T_Pax_ALA_10_concatenated	ALA
T_Pax_ALA_11_concatenated	ALA
T_Pax_ALA_12_concatenated	ALA
T_Pax_ALA_13_concatenated	ALA
T_Pax_ALA_14_concatenated	ALA
T_Pax_ALA_15_concatenated	ALA
T_Pax_ALA_16_concatenated	ALA
T_Pax_ALA_19_concatenated	ALA
T_Pax_ALA_1_concatenated	ALA
T_Pax_ALA_20_concatenated	ALA
T_Pax_ALA_21_concatenated	ALA
T_Pax_ALA_2_concatenated	ALA
T_Pax_ALA_3_concatenated	ALA
T_Pax_ALA_4_concatenated	ALA
T_Pax_ALA_5_concatenated	ALA
T_Pax_ALA_6_concatenated	ALA
T_Pax_ALA_7_concatenated	ALA
T_Pax_ALA_8_concatenated	ALA
T_Pax_ALA_9_concatenated	ALA
T_Pax_ALAOR_10_concatenated	ALAOR
T_Pax_ALAOR_12_concatenated	ALAOR
T_Pax_ALAOR_15_concatenated	ALAOR
T_Pax_ALAOR_16_concatenated	ALAOR
T_Pax_ALAOR_5_concatenated	ALAOR
T_Pax_ALAOR_6_concatenated	ALAOR
T_Pax_ALAOR_8_concatenated	ALAOR
T_Pax_ALAOR_9_concatenated	ALAOR
T_Pax_ALO_14_concatenated	ALO
T_Pax_ALO_18_concatenated	ALO
T_Pax_ALO_3_concatenated	ALO
T_Pax_ALO_4_concatenated	ALO
T_Pax_CAMP_10_concatenated	CAMP
T_Pax_CAMP_11_concatenated	CAMP
T_Pax_CAMP_1_concatenated	CAMP
T_Pax_CAMP_2_concatenated	CAMP
T_Pax_CAMP_3_concatenated	CAMP
T_Pax_CAMP_4_concatenated	CAMP
T_Pax_CAMP_5_concatenated	CAMP
T_Pax_CAMP_6_concatenated	CAMP
T_Pax_CAMP_7_concatenated	CAMP
T_Pax_CAMP_8_concatenated	CAMP
T_Pax_CAMP_9_concatenated	CAMP
T_Pax_CUB_10a_concatenated	CUB
T_Pax_CUB_10c_concatenated	CUB
T_Pax_CUB_1a_concatenated	CUB
T_Pax_CUB_1b_concatenated	CUB
T_Pax_CUB_2A_concatenated	CUB
T_Pax_CUB_2B_concatenated	CUB
T_Pax_CUB_3A_concatenated	CUB
T_Pax_CUB_4a_concatenated	CUB
T_Pax_CUB_4b_concatenated	CUB
T_Pax_CUB_7a_concatenated	CUB
T_Pax_EST_12_concatenated	EST
T_Pax_EST_13_concatenated	EST
T_Pax_EST_1_concatenated	EST
T_Pax_EST_2_concatenated	EST
T_Pax_EST_4_concatenated	EST
T_Pax_EST_9_concatenated	EST
T_Pax_GIA_15_concatenated	GIA
T_Pax_GIA_18_concatenated	GIA
T_Pax_GIA_19_concatenated	GIA
T_Pax_GIA_21_concatenated	GIA
T_Pax_GIA_24_concatenated	GIA
T_Pax_GIA_25_concatenated	GIA
T_Pax_GIA_30_concatenated	GIA
T_Pax_GIA_31_concatenated	GIA
T_Pax_GIA_33_concatenated	GIA
T_Pax_GIA_34_concatenated	GIA
T_Pax_GIA_36_concatenated	GIA
T_Pax_GIA_37_concatenated	GIA
T_Pax_PTF_11_concatenated	PTF
T_Pax_PTF_12_concatenated	PTF
T_Pax_PTF_13_concatenated	PTF
T_Pax_PTF_14_concatenated	PTF
T_Pax_PTF_15_concatenated	PTF
T_Pax_PTF_16_concatenated	PTF
T_Pax_PTF_17_concatenated	PTF
T_Pax_PTF_18_concatenated	PTF
T_Pax_PUG_A1_concatenated	PUG
T_Pax_PUG_A2_concatenated	PUG
T_Pax_PUG_A4_concatenated	PUG
T_Pax_PVEN_11_concatenated	PVEN
T_Pax_PVEN_13_concatenated	PVEN
T_Pax_PVEN_14_concatenated	PVEN
T_Pax_PVEN_15_concatenated	PVEN
T_Pax_PVEN_3_concatenated	PVEN
T_Pax_PVEN_6_concatenated	PVEN
T_Pax_PVENOR_10_concatenated	PVENOR
T_Pax_PVENOR_13_concatenated	PVENOR
T_Pax_PVENOR_14_concatenated	PVENOR
T_Pax_PVENOR_15_concatenated	PVENOR
T_Pax_PVENOR_16_concatenated	PVENOR
T_Pax_PVENOR_17_concatenated	PVENOR
T_Pax_PVENOR_18_concatenated	PVENOR
T_Pax_PVENOR_19_concatenated	PVENOR
T_Pax_PVENOR_1_concatenated	PVENOR
T_Pax_PVENOR_20_concatenated	PVENOR
T_Pax_PVENOR_2_concatenated	PVENOR
T_Pax_PVENOR_3_concatenated	PVENOR
T_Pax_PVENOR_5_concatenated	PVENOR
T_Pax_PVENOR_6_concatenated	PVENOR
T_Pax_SAR_20_concatenated	SAR
T_Pax_SAR_21_concatenated	SAR
T_Pax_SAR_23_concatenated	SAR
T_Pax_SAR_24_concatenated	SAR
T_Pax_SAR_25_concatenated	SAR
T_Pax_SAR_26_concatenated	SAR
T_Pax_GIAOR_32_concatenated	GIAOR
T_Pax_GIAOR_35_concatenated	GIAOR
T_Pax_GIAOR_36_concatenated	GIAOR
T_Pax_GIAOR_38_concatenated	GIAOR
T_Pax_GIAOR_40_concatenated	GIAOR
T_Pax_GIAOR_39_concatenated	GIAOR
T_Pax_SAROR_16_concatenated	SAROR
T_Pax_SAROR_18_concatenated	SAROR
T_Pax_SAROR_19_concatenated	SAROR
T_Pax_SAROR_17_concatenated	SAROR
T_Pax_SAROR_3_concatenated	SAROR
T_Pax_SAROR_1_concatenated	SAROR
T_Pax_SAROR_2_concatenated	SAROR
