Sample_ID	MorphotypePopulation	Morphotype	Population
T_Pax_ALA_10_concatenated	SlenderALA	Slender	ALA
T_Pax_ALA_11_concatenated	SlenderALA	Slender	ALA
T_Pax_ALA_12_concatenated	SlenderALA	Slender	ALA
T_Pax_ALA_13_concatenated	SlenderALA	Slender	ALA
T_Pax_ALA_14_concatenated	SlenderALA	Slender	ALA
T_Pax_ALA_15_concatenated	SlenderALA	Slender	ALA
T_Pax_ALA_16_concatenated	SlenderALA	Slender	ALA
T_Pax_ALA_19_concatenated	SlenderALA	Slender	ALA
T_Pax_ALA_1_concatenated	SlenderALA	Slender	ALA
T_Pax_ALA_20_concatenated	SlenderALA	Slender	ALA
T_Pax_ALA_21_concatenated	SlenderALA	Slender	ALA
T_Pax_ALA_2_concatenated	SlenderALA	Slender	ALA
T_Pax_ALA_3_concatenated	SlenderALA	Slender	ALA
T_Pax_ALA_4_concatenated	SlenderALA	Slender	ALA
T_Pax_ALA_5_concatenated	SlenderALA	Slender	ALA
T_Pax_ALA_6_concatenated	SlenderALA	Slender	ALA
T_Pax_ALA_7_concatenated	SlenderALA	Slender	ALA
T_Pax_ALA_8_concatenated	SlenderALA	Slender	ALA
T_Pax_ALA_9_concatenated	SlenderALA	Slender	ALA
T_Pax_ALAOR_10_concatenated	OrangeALAOR	Orange	ALAOR
T_Pax_ALAOR_12_concatenated	OrangeALAOR	Orange	ALAOR
T_Pax_ALAOR_15_concatenated	OrangeALAOR	Orange	ALAOR
T_Pax_ALAOR_16_concatenated	OrangeALAOR	Orange	ALAOR
T_Pax_ALAOR_5_concatenated	OrangeALAOR	Orange	ALAOR
T_Pax_ALAOR_6_concatenated	OrangeALAOR	Orange	ALAOR
T_Pax_ALAOR_8_concatenated	OrangeALAOR	Orange	ALAOR
T_Pax_ALAOR_9_concatenated	OrangeALAOR	Orange	ALAOR
T_Pax_ALO_14_concatenated	SlenderALO	Slender	ALO
T_Pax_ALO_18_concatenated	SlenderALO	Slender	ALO
T_Pax_ALO_3_concatenated	SlenderALO	Slender	ALO
T_Pax_ALO_4_concatenated	SlenderALO	Slender	ALO
T_Pax_CAMP_10_concatenated	SlenderCAMP	Slender	CAMP
T_Pax_CAMP_11_concatenated	SlenderCAMP	Slender	CAMP
T_Pax_CAMP_1_concatenated	SlenderCAMP	Slender	CAMP
T_Pax_CAMP_2_concatenated	SlenderCAMP	Slender	CAMP
T_Pax_CAMP_3_concatenated	SlenderCAMP	Slender	CAMP
T_Pax_CAMP_4_concatenated	SlenderCAMP	Slender	CAMP
T_Pax_CAMP_5_concatenated	SlenderCAMP	Slender	CAMP
T_Pax_CAMP_6_concatenated	SlenderCAMP	Slender	CAMP
T_Pax_CAMP_7_concatenated	SlenderCAMP	Slender	CAMP
T_Pax_CAMP_8_concatenated	SlenderCAMP	Slender	CAMP
T_Pax_CAMP_9_concatenated	SlenderCAMP	Slender	CAMP
T_Pax_CUB_10a_concatenated	SlenderCUB	Slender	CUB
T_Pax_CUB_10c_concatenated	SlenderCUB	Slender	CUB
T_Pax_CUB_1a_concatenated	SlenderCUB	Slender	CUB
T_Pax_CUB_1b_concatenated	SlenderCUB	Slender	CUB
T_Pax_CUB_2A_concatenated	SlenderCUB	Slender	CUB
T_Pax_CUB_2B_concatenated	SlenderCUB	Slender	CUB
T_Pax_CUB_3A_concatenated	SlenderCUB	Slender	CUB
T_Pax_CUB_4a_concatenated	SlenderCUB	Slender	CUB
T_Pax_CUB_4b_concatenated	SlenderCUB	Slender	CUB
T_Pax_CUB_7a_concatenated	SlenderCUB	Slender	CUB
T_Pax_EST_12_concatenated	SlenderEST	Slender	EST
T_Pax_EST_13_concatenated	SlenderEST	Slender	EST
T_Pax_EST_1_concatenated	SlenderEST	Slender	EST
T_Pax_EST_2_concatenated	SlenderEST	Slender	EST
T_Pax_EST_4_concatenated	SlenderEST	Slender	EST
T_Pax_EST_9_concatenated	SlenderEST	Slender	EST
T_Pax_GIA_15_concatenated	SlenderGIA	Slender	GIA
T_Pax_GIA_18_concatenated	SlenderGIA	Slender	GIA
T_Pax_GIA_19_concatenated	SlenderGIA	Slender	GIA
T_Pax_GIA_21_concatenated	SlenderGIA	Slender	GIA
T_Pax_GIA_24_concatenated	SlenderGIA	Slender	GIA
T_Pax_GIA_25_concatenated	SlenderGIA	Slender	GIA
T_Pax_GIA_30_concatenated	SlenderGIA	Slender	GIA
T_Pax_GIA_31_concatenated	SlenderGIA	Slender	GIA
T_Pax_GIA_33_concatenated	SlenderGIA	Slender	GIA
T_Pax_GIA_34_concatenated	SlenderGIA	Slender	GIA
T_Pax_GIA_36_concatenated	SlenderGIA	Slender	GIA
T_Pax_GIA_37_concatenated	SlenderGIA	Slender	GIA
T_Pax_PTF_11_concatenated	SlenderPTF	Slender	PTF
T_Pax_PTF_12_concatenated	SlenderPTF	Slender	PTF
T_Pax_PTF_13_concatenated	SlenderPTF	Slender	PTF
T_Pax_PTF_14_concatenated	SlenderPTF	Slender	PTF
T_Pax_PTF_15_concatenated	SlenderPTF	Slender	PTF
T_Pax_PTF_16_concatenated	SlenderPTF	Slender	PTF
T_Pax_PTF_17_concatenated	SlenderPTF	Slender	PTF
T_Pax_PTF_18_concatenated	SlenderPTF	Slender	PTF
T_Pax_PUG_A1_concatenated	SlenderPUG	Slender	PUG
T_Pax_PUG_A2_concatenated	SlenderPUG	Slender	PUG
T_Pax_PUG_A4_concatenated	SlenderPUG	Slender	PUG
T_Pax_PVEN_11_concatenated	SlenderPVEN	Slender	PVEN
T_Pax_PVEN_13_concatenated	SlenderPVEN	Slender	PVEN
T_Pax_PVEN_14_concatenated	SlenderPVEN	Slender	PVEN
T_Pax_PVEN_15_concatenated	SlenderPVEN	Slender	PVEN
T_Pax_PVEN_3_concatenated	SlenderPVEN	Slender	PVEN
T_Pax_PVEN_6_concatenated	SlenderPVEN	Slender	PVEN
T_Pax_PVENOR_10_concatenated	OrangePVENOR	Orange	PVENOR
T_Pax_PVENOR_13_concatenated	OrangePVENOR	Orange	PVENOR
T_Pax_PVENOR_14_concatenated	OrangePVENOR	Orange	PVENOR
T_Pax_PVENOR_15_concatenated	OrangePVENOR	Orange	PVENOR
T_Pax_PVENOR_16_concatenated	OrangePVENOR	Orange	PVENOR
T_Pax_PVENOR_17_concatenated	OrangePVENOR	Orange	PVENOR
T_Pax_PVENOR_18_concatenated	OrangePVENOR	Orange	PVENOR
T_Pax_PVENOR_19_concatenated	OrangePVENOR	Orange	PVENOR
T_Pax_PVENOR_1_concatenated	OrangePVENOR	Orange	PVENOR
T_Pax_PVENOR_20_concatenated	OrangePVENOR	Orange	PVENOR
T_Pax_PVENOR_2_concatenated	OrangePVENOR	Orange	PVENOR
T_Pax_PVENOR_3_concatenated	OrangePVENOR	Orange	PVENOR
T_Pax_PVENOR_5_concatenated	OrangePVENOR	Orange	PVENOR
T_Pax_PVENOR_6_concatenated	OrangePVENOR	Orange	PVENOR
T_Pax_SAR_20_concatenated	SlenderSAR	Slender	SAR
T_Pax_SAR_21_concatenated	SlenderSAR	Slender	SAR
T_Pax_SAR_23_concatenated	SlenderSAR	Slender	SAR
T_Pax_SAR_24_concatenated	SlenderSAR	Slender	SAR
T_Pax_SAR_25_concatenated	SlenderSAR	Slender	SAR
T_Pax_SAR_26_concatenated	SlenderSAR	Slender	SAR
T_Pax_GIAOR_32_concatenated	OrangeGIAOR	Orange	GIAOR
T_Pax_GIAOR_35_concatenated	OrangeGIAOR	Orange	GIAOR
T_Pax_GIAOR_36_concatenated	OrangeGIAOR	Orange	GIAOR
T_Pax_GIAOR_38_concatenated	OrangeGIAOR	Orange	GIAOR
T_Pax_GIAOR_40_concatenated	OrangeGIAOR	Orange	GIAOR
T_Pax_GIAOR_39_concatenated	OrangeGIAOR	Orange	GIAOR
T_Pax_SAROR_16_concatenated	OrangeSAROR	Orange	SAROR
T_Pax_SAROR_18_concatenated	OrangeSAROR	Orange	SAROR
T_Pax_SAROR_19_concatenated	OrangeSAROR	Orange	SAROR
T_Pax_SAROR_17_concatenated	OrangeSAROR	Orange	SAROR
T_Pax_SAROR_3_concatenated	OrangeSAROR	Orange	SAROR
T_Pax_SAROR_1_concatenated	OrangeSAROR	Orange	SAROR
T_Pax_SAROR_2_concatenated	OrangeSAROR	Orange	SAROR
